##################################################################################
#        #            #        #            #        #            #        #     #
#        #            #        #            #        #            #        #     #
####/######### ###################################################################
#        #            #        #            #        #            #        #     #
#                     /        #            #        /            #        #     #
####/######### ###############################################/############### ###
#        #            #        #            #        #            #        #     #
#        #            #        #            #        #            /        /     #
#### ######### ###############################################/############### ###
#        #            #        #            #        #            #        #     #
#        #            #        #            #        #            #        #     #
#### ######### ###############################################/############### ###
#        #            #        #            #        #            #        #     #
#        #            /        /            /        /            #        #     #
#### #####            #### #####     @      ####/#####            ##########     #
#        #            #        #            #        #            #        #     #
#        /            #        #            #        #            /        #     #
##################################################################################