##################################################################################
#   M    #            #        #            #        #            #        #     #
#        #            #        #            #        #            #        #     #
####/######### ######################/############################################
#        #            #        #            #        #            #        #     #
#                     /        /     M      #        /            #        #     #
####/######### ######################/########################/############### ###
#        #            #        #            #        #            #        #     #
#        #            #        #            #        #            /        /     #
#### ######### ######################/########################/############### ###
#        #            #        #            #        #            #        #     #
#        #            #        #            #        #            #        #     #
#### ######### ###############################################/############### ###
#        #            #        #            #        #            #        #     #
#        #            /        /            /        /            #        #     #
#### #####            #### #####     @      ####/#####            ##########     #
#        #            #        #            #        #            #        #     #
#        /            #        #            #        #            /        #     #
##################################################################################